吴琳	F
苏研	M
李海	M
孙一哲	M
邓国通	M
代郑	M
樊瑜	F
陈飞	M
张圣洁	F
仲伟博	M
卢学思	M
祝锐	M
江珊	F
李星星	F
陈佳煜	M
吕嘉晖	M
庸宏伟	M
刘子羽	F
朱冠宇	M
李佳宾	M
安鑫	M
何彦平	M
别小娟	F
刘超	M
何科佑	M
古锦韬	M
高超	M
郭海礁	F
刘雅馨	F
秦艳玲	F
邵婉婷	F
王涵	F
张斌	F
吴婉蓉	F
陈冠浩	M
何艾莲	F
宝双慧	F
王巧	F
鄂倩倩	F
高菲	F
张天琪	F
贺方昕	F
张昕阳	F
黄文靓	F
田林青	F
黄锦	F
盛紫琼	F
杨正委	M
张甜甜	F
童臻	F
杜瑾	F
李天骄	F
张洋洋	M
邵永纯	M
方哲	M
雷声	M
余丰	F
黄光耀	M
王一璠	M
王捷	M
荆学毅	M
徐赵博	M
张晶阳	M
剡苏文	M
陈钇茹	F
彭景光	M
刘福元	M
沈俊旭	M
袁庆龙	M
颜晓明	M
孙天飞	M
马良	M
张少秋	M
郭然	F
陈嘉凯	M
陈杨	F
冯骞	M
高彬	M
顾志强	M
刘晓明	M
马增贤	M
田涵	M
王安阳	F
王若宇	M
韦金昊	M
夏浩宇	M
夏有胜	M
许强	M
余良	M
张鑫	M
蒋昊雨	M
王宏羽	M
叶波	M
俞佳熠	F
曹健文	M
刘励	F
张立君	F
陈茜	F
余康宁	M
黄永平	M
付瑜琳	M
张晓华	M
徐向春	M
郑修宇	M
郭子钰	F
阿凉木沙各	F
邢琰	F
周兴俊	M
高子琪	M
刘思彤	F
王新楠	M
张冲	M
符赫	M
李伟强	M
叶星	M
陈栋	M
蔡超	M
韩留洋	M
黄迪	M
黄汉玺	M
魏正杰	M
杨文生	M
朱凯雄	M
汪英祚	M
韩瑞星	F
闫海	M
牛嘉琪	F
周金力	M
周文萌	F
林晨	M
沈赞秋	M
刘博琰	F
吴晨阳	M
吴太晖	M
李宏正	M
庄荣津	M
王冰倩	F
李文鹏	M
付尧	F
李心怡	F
李良涛	M
金广	M
涂瑞	F
张春利	M
秦至臻	M
张爽	F
袁国萍	F
字兰芳	F
邹洋	F
管浩	M
段国芳	F
何莹	F
郝珊	F
徐苹	F
周垚学	M
冀彤彤	F
占在福	M
郭嘉豪	M
张亚飞	M
刘宇铭	M
周麟炜	M
刘朋印	M
于晓明	M
涂彦昕	M
邵仕超	M
韩明远	M
陈禹聪	M
顾欣宇	F
胡昊	M
黄佳胜	M
黄哲恒	M
庞景豪	M
谭镇东	M
燕秀	F
杨佳欣	F
杨天舒	M
翟放	M
张天枫	M
张娅琴	F
张芸惠	F
赵恺	M
魏欣宇	M
向柏澄	M
宾光祥	M
邴兆栋	M
曹正	M
陈佳榕	M
陈静福	M
陈可欣	F
陈星宇	M
陈艺云	F
陈英杰	M
程迟	F
邓焕	M
侯丰凡	M
贾子谦	M
解元	M
李聪聪	F
李佳委	M
卢海鹏	M
卢致远	M
蒙治伸	M
平钰坤	F
王泽	M
胥智林	M
张莉	F
张元鑫	M
徐茹宁	F
于子珺	F
郑泽坤	F
杨龙威	M
肖志宾	M
张国栋	M
武燕敏	F
汪博文	M
沈叶青	M
张经伟	M
张振铎	M
张明	M
陈雷	M
孙万虎	M
邓戈	M
艾浩	M
褚家铭	M
王子瑞	M
杨剑鸣	M
马俊野	M
吕凯	M
沈文丽	F
赵向宇	M
陶建	M
郑辛发	M
张明明	M
徐乐阳	M
朱博弘	M
陈斌	M
黄尚川	M
黄海	M
张宇为	M
张文杰	F
毛科龙	M
崔延宣	M
蔡雄	M
李鑫	M
叶连金	M
谢家旺	M
徐晨宁	M
柏杨	M
郭宇	M
赖训齐	M
凌思通	M
赵飞鸿	M
吕志亨	M
梁翔宇	M
李丰廷	M
郭嘉伟	M
严浩鹏	M
黄晖榕	M
姜伟峰	M
王栋	M
冯岩	M
郭颖美	F
欧阳植昊	M
贺子昊	M
刘旋恺	M
阳佳城	M
张泽宇	M
李博	M
吴思凡	F
章鹏	F
丁强刚	M
江祖铭	M
郝天博	M
赵博文	M
魏萌	F
李自然	M
林子博	M
袁晨曦	F
吕咸斌	M
卞天	M
黄河	M
石佳妍	F
蔡佳音	F
苏斌	M
戴晶	M
贾邵程	M
高艺华	F
唐榕氚	M
青鹏	M
王亚伟	M
代立言	M
夏桑禹	M
吴刚	M
朱呈炜	M
万小培	M
辛开发	M
高旭	M
赵磊	M
杨帆	M
陈泉	M
王西利	M
周畅	M
李泽阳	M
徐广远	M
钟立	M
易彤	F
张睿文	M
夏明	M
郑畅畅	M
常健新	M
曹禹	M
李峻琦	M
陈文	M
陈旭	M
李婷伟	F
董九阳	M
包磊	M
张磊	M
杨辰	M
姜鑫烨	M
吴天琦	F
何超	M
吴静	M
龚德政	M
曹诗云	F
涂强	M
刘昌华	M
王志辉	M
程淏	M
张驰	M
王浩伟	M
何超	M
何佳宝	M
李永强	M
刘阳哲	M
刘志宏	M
司鹏达	M
徐丁丁	M
张艺杨	F
周蔚	F
周子乐	M
姜添元	M
周容辰	M
翟宇鹏	M
张郑	M
周忻旸	M
林晓光	M
李频捷	F
王晨骁	M
苏卓	M
唐荣校	M
宋庆禹	M
王超	M
陈锦华	M
孙绪福	M
李金泽	M
刘奇	M
闵波	M
李广涵	M
周星如	F
黄鑫	F
钟婷婷	F
许卓群	F
路万通	M
张希雅	F
张皓	F
张召	M
胡泰锋	M
盛健淞	M
马列君	M
孙庆斌	M
党子越	M
宋照午	M
王麒淋	M
巩杰	M
周璟	M
孙鸣	M
任杰	M
刘壮志	M
吴沫君	F
冯书林	F
姜立伟	M
王元楷	M
魏禹珲	F
周晟娟	F
陈韵竹	F
朱科嘉	M
李重阳	M
王佳文	F
原宝芬	F
韩筱琳	F
张中汉	M
侯宗昇	M
苏舒琴	F
张叶萌	F
姜颜曹	M
陈沂蒙	M
冷洋洋	F
卢天琦	M
刘明阳	M
万子祥	M
王权胜	M
郑雪	F
陈华平	M
廖青	F
田彬人	F
董盛M	F
黄瑶	F
李成罡	M
吴茜凤	F
张博	M
邵国辉	M
孙策	M
奚鑫威	M
刘乙彤	M
侯利兵	M
胡峻豪	M
杨索	M
吕惠	M
蔡兆玮	M
张超	M
章腾飞	M
马娜	F
张驰	F
周鹏飞	M
黄凯鑫	M
李睿之	M
王孜劼	M
郝以昇	M
李世民	M
姜文宇	M
王豪	M
刘彤	F
刘杰	M
张伟	M
李子坤	M
邬超	M
王天宇	M
梁俊威	M
杨坤	M
辛泽宇	M
王永杰	M
李泽健	M
王阳	M
邵飞	M
王新亮	M
杨嘉业	M
高香灵	F
湛厚超	M
李雪	F
武海燕	F
陈志浩	M
郭旭	M
李岚欣	M
李想	M
李雨泰	M
刘杰明	M
夏昊天	M
项楚原	M
徐向宇	M
庄力	M
陆益铭	F
孙优	F
周智行	M
俞静	F
樊浩楠	M
袁泽正	M
黄帝郡	F
王杰	M
李纳瑞	F
李富颖	M
赵瑞	F
王宇欣	F
陈宏宇	F
刘芳	F
陈超杰	M
邢依蒙	F
徐闻辛	M
王峰	M
芦英	F
陈立坤	M
刘奕博	M
王凌霄	M
钱龙	M
李勇胜	M
钱海涛	M
翟伟	M
吴永乐	M
郭宗昌	M
郑甘雨	F
刘媛	F
蔡晓明	M
黄文婷	F
王胜	M
胡生浩	M
王飞鹏	M
梁忻	M
张心	F
张玲玲	F
黄旭东	M
曾晓婕	F
关小石	M
张元玺	M
周泓江	M
李欢欢	F
刘雯	F
马家宾	M
朱明远	M
凌华金	F
童静	M
章国强	M
韩志远	M
刘梦静	F
曾祥天	M
钱瑞	M
过冬冬	M
李恒	M
赵李川	M
张宸	M
刘昱宏	F
吴伯瑶	F
李佳彤	F
梁书然	F
丁艺佩	F
王紫晴	F
王美麒	F
王哲	M
詹凤	F
陈丹琦	F
雷鑫	M
何欣知	M
牛泽东	M
李军霖	M
郭梦飞	M
李欣泽	F
孙磊	M
周东晟	M
丁潇晗	M
程超意	M
林子晗	M
刘德斐	F
刘之诚	M
乔诗钦	M
叶薇	F
赵鹏程	M
李燕宁	F
马腾起	M
王明辉	F
徐殷韬	M
曹博航	M
陈紫茜	F
仇泽民	M
戴健圣	M
付冰冰	F
干思扬	M
高明辉	M
高明哲	M
郭开源	F
胡邱钰	F
黄家伦	M
黄紫衡	M
嵇舒婷	F
简志鑫	M
靳盼盼	M
黎荣舜	M
李健行	M
李梦楠	M
李振寰	M
林铭杰	M
刘俊	M
刘志暄	M
吕一鸣	M
马海宁	F
南春星	M
彭宇熙	M
施鹏翔	M
史易萌	F
孙乙钧	M
涂宝立	M
王艺妮	F
王卓程	M
魏婧祎	F
吴晨贝	M
肖雨杰	M
谢文茜	F
徐义深	M
于一丁	F
张劭琨	M
张书语	M
张肇维	M
张子奇	M
周冠廷	F
周锐	M
朱印	M
邹昱旻	M
李雨婕	F
石铠	M
石蕊	F
唐天阳	M
王嘉冬	M
袁姚杰	M
冯至诚	M
左堃	M
陈思臻	M
贾夏杰	M
阚傲	M
商熠峰	M
于棚土	M
漆川烨	M
吴昂达	M
郑名洋	M
段明皓	M
胡飘	M
雷泽成	M
林雨辰	M
吴思源	M
庄学靖	M
从文涛	M
郭星汝	F
支音	F
申宗航	M
李妍君	F
任和青	F
宋依梦	F
牛嘉桐	M
杨凯	M
陈岱	M
李方凯	M
熊春慧	F
黄茂琛	M
刘思远	M
孟子良	M
张彦麟	M
黄伟宾	M
夏玲佳	F
杨昊	M
曹承全	M
龚志忠	M
张耀洋	M
王梓	F
吴义天	M
吴梦曦	F
武曦蔼	F
赵培	F
范冀缓	F
潘紫曜	M
张洋	M
王禹	F
刘宇飞	M
李兵	M
郑庆锋	M
张媛媛	F
曹双军	M
衡量	M
张佳林	M
王燕伟	M
刘彦宾	M
程龙	M
姜丽平	F
蒋晓辉	M
马永莉	F
张环宇	F
白杰文	M
何佳琳	F
李永生	M
陈钰心	F
路启浩	M
张松宇	M
赵雪营	F
范姗姗	F
谭振严	F
张晓淑	F
杨思瑶	F
陶俊杰	M
陈李炎	M
吕艺芝	F
王叶	F
张奕婷	F
廖美霞	F
覃德清	F
唐项涛	M
杨静逸	F
朱丽都孜·解思思别克	F
王艺璇	F
徐沁怡	F
张子豪	M
郭齐博	M
何润珺	F
王晗堃	F
邹嘉俐	F
杨珊珊	F
沙杰	M
岳晓菲	F
陈晓晨	F
杜晓静	F
张拓	F
高涵	M
张宝龄	F
陈洁纯	F
李洋	M
徐世清	M
陶元	F
王越	F
尹家发	M
杨朔	F
苏可馨	F
张静怡	F
冯慧敏	F
张艺龄	F
田佳	F
王益璐	F
彭怀	M
刘澎	M
蔡广一	M
周洲	M
潘香军	F
秦嘉泽	F
喻龙	M
张亮	M
朱佩	F
郭昊	M
曹斯禺	F
姜凯燊	M
陈禹璇	F
郭栩	F
孙铭蔚	M
唐龙	M
许佳楠	F
张欣然	F
陈青青	F
韦雪阳	F
仇宇	F
王萍	F
易聪	F
钟子颖	F
楼申吉	M
郏奇	M
郭豪豪	F
林世星	M
陈帮剑	M
吕键茹	F
张同顺	M
孙丰涛	M
程康	M
毛一凡	M
谭远志	M
班向蒙	M
李锐	M
马明昊	M
李玲	F
王杨子	F
邱威栋	M
陆慧琪	F
欧顺发	M
韩雨岚	F
屈尘	M
张鹏	M
郭丽阳	F
江小红	F
许景铭	M
李冲	F
董婷婷	F
杜晓雄	M
孟祥正	M
陈艳超	F
姜碧霞	F
杨敏荣	M
金佳莉	F
曲雪薇	F
王英健	M
黄圣乔	F
熊雨蓉	F
范慧慧	F
郭翀	F
郭嘉仪	F
李莹	F
梁秋婵	F
刘怡敏	F
潘心怡	F
商慧心	F
邵鑫坪	F
汪永琴	F
王简	F
吴婧	F
谢慢慢	F
杨雅捷	F
张凝果	F
韩琛	F
路惠然	F
姜浩	M
黄婷婷	F
薛迪	F
成雪琪	F
张明谦	M
林子祥	M
杨圣玥	F
仉策	M
王雅怡	F
武文博	M
常煊铭	M
张培源	M
黄瀚瑶	F
于静涵	F
张帅	M
邹予琪	F
彭宪辉	F
万尽涵	F
洪航斌	M
翁天昊	M
李睿	F
成佳佳	F
何俊寰	M
韩维	F
涂欣培	F
田艳飞	F
徐梦瑶	F
闫欣晴	F
王静静	F
叶志远	F
徐雅鑫	M
白云蔚	F
李妍婧	F
段素娜	F
扈钟方	M
李俊琪	M
区绮琳	F
余焯雄	M
杨欢晴	F
纪思源	F
黄慧	F
宋文轩	M
葛曙雯	F
张江淼	F
关莹	F
王虹	F
马悦	F
曾子悦	F
李春晖	F
吕佳芸	F
熊奇	F
郑莹莹	F
张琰	F
李竺夢	F
王启欣	F
唐慧雯	F
赵晨菲	F
吕笑语	F
徐婷	F
张力文	F
赵婉蓉	F
辛颖	F
陈溢清	F
崔云涛	F
祁宝莹	F
韩啸宇	F
尚文意	F
胡曦彤	F
李笑	F
周英格	F
麻燕青	F
傅晓彤	F
余世骏	M
张学生	M
赵晓志	M
周佰顺	M
徐艺然	F
许启之	M
徐宜蕙	F
杨倩熙	F
贺继帅	M
刘舒婷	F
张宇	M
闫一默	M
夏丽	F
钟素艺	F
李嘉晋	M
胡梦颖	F
黄熔熔	F
高启予	M
沈元星	M
许蔼雯	F
沙洲	M
管淑祎	F
王义达	M
赵雅萍	F
赵涵羽	F
陈致远	M
罗钧杰	M
柳思杨	F
熊振文	M
陈雅雯	F
周雪	F
黄维啸	M
张国庆	M
柳璐	F
刘鑫	M
付文韬	M
李佳栋	M
孙王斌	M
杨泽龙	M
周箫	M
梁艺铧	M
张傲阳	F
夏周睿	M
张霄	F
王晶冰	F
罗莉舒	F
徐曳恺	M
王玥	F
王传赞	M
王婉	F
邓起谱	M
王子丰	M
刘文龙	M
刘锦涛	M
汤玮韬	M
汪茗纯	F
马梦伶	F
廖文惠	F
谭淑方	F
张凌霄	M
金鼎健	M
许良晟	M
杨子曦	F
侯宇	F
李子纯	F
方颉	M
尹思凯	M
罗书琴	F
廖敬仪	F
徐哲	M
李思楠	M
张奕	M
郭雨萌	F
吴思瑾	F
李一鸣	M
翟同庆	M
潘旺	M
朱天磊	M
陈翔宇	M
张宇扬	M
聂鹏博	M
罗以好	M
施润叶	F
张礼颖	F
杨景博	M
陈贵斌	M
阳天舒	M
王龙	M
李振龙	M
赵聪	M
孙璘钊	F
尹明健	M
汪炼成	M
王涵民	M
唐天浩	M
徐星雨	F
赵伊然	F
周子豪	M
周赫元	M
赖泳爵	M
王菊婷	F
宋甜甜	F
吴娟	F
赵心怡	F
黄晨	F
许雅澜	F
甘霖	F
舒韩	F
梁蕾	F
刘柯迪	M
杨丰宁	F
周耀	M
胡志伟	M
叶成	M
姚越	F
徐雅倩	F
李因	F
陈荣周	M
张海龙	M
彭枭	M
于苗苗	F
侯宇佳	F
谢逸轩	F
董璐	F
刘宇迪	F
孙伟政	M
孙鹏博	M
林广兰	F
赵倩	F
刘华婷	F
喻萧桦	F
邓婷	F
陈艺璇	F
陈俊粤	M
贾兆年	M
馮志斌	M
黄爱彤	F
蘇傑華	M
蘇裕勝	M
林源青	M
黄杰廉	M
黄驰	M
张琪腾	M
郭芙蓉	F
叶文斌	M
简慧敏	F
樊启明	M
廖添诚	M
李世隆	M
陈博智	M
梁熙	M
尚海龙	M
林琳	F
李淑慧	F
杨文锐	M
黃頴灝	M
林振升	M
陈伟伦	M
姚洁凝	F
黃子琦	M
张瑞锋	M
黎智成	M
胡健民	M
郭俊	M
郑松岩	M
梅怿熙	M
何国桓	M
梁键玮	M
游立仁	M
沈兆铭	M
李世荣	M
赵欣宇	F
冯唯嘉	F
海娜	F
阿贝托	M
崔晨曲	F
NAEEM, MAIMONA	F
GULZAR, MUHAMMAD UMA	M
张祖钰	F
麦烤	M
张奕麟	M
LO, YUI	M
纳尔	M
DHAKSHAYANI KUMAR, S	F
YADAV, RAVI	M
陈颖	F
李隽荣	M
ALAM, BEHZAD	M
DANESHI, SOROUSH	M
陈希	F
郑华冬	M
蔡青青	F
陈丽	F
胡佳慧	F
刘阳	F
杨彩凤	F
孙震	M
杨梦颖	F
张乾	M
段宏达	M
臧永森	M
程启问	M
李明哲	M
安淑敏	F
李石峰	M
武智源	M
丁宁	M
高英华	M
何玥	M
李磊	M
李欣阳	M
于炳耀	M
张如心	F
周天贶	M
徐建东	M
张晨曦	M
康永强	M
刘鹏	M
史沛然	M
苏宁	F
章立寒	M
邵聪慧	F
宋家玮	F
王春楠	M
周冲琪	M
樊婷婷	F
李安祺	M
司月雷	M
肖博仁	M
冯春燕	F
刘星宇	F
王彦志	M
晏琦	M
吴君毅	F
史书豪	M
王韩晗	F
刘一蓉	F
程理荣	M
李乃琦	M
刘含笑	F
栾泽宇	M
童鑫熠	M
王东凯	M
袁艺天	F
张安科	M
常馨月	F
李若冰	M
李想	M
刘晓彤	F
刘兴禄	M
彭露	F
苏明	M
谭隽阳	M
滕长久	M
汪科全	M
王丹	F
王二青	F
王婧云	F
王童瑶	F
王啸天	M
吴曦	M
杨闯	M
仪忠凯	M
张琛	F
张致远	M
代小勇	M
郭慧	F
李尧	M
林乾宇	M
卢致铨	M
司鲁	M
汤笑薇	F
王佳琪	M
王雪娟	F
袁天莹	F
张亚南	F
张子琪	F
黃安琪	F
管琼瑛	F
守敬	M
关诺飞	M
	
	
